b00000000b
0b00000000
0b00000000
0b00000000
0b00000000
0b00000000
0b00000000
0b00000000
0b00000000
bb00h0i00b