b00000000b
0b00000000
0b00000000
0b00bb0000
0b00bb0000
0b00bb0000
0b00000000
0b00000000
0b00000000
bb0ph0i00b